fángdào|防盗
fánghuǒ|防火
xiàoyuán|校园
pǎobù|跑步
dàmén|大门
suǒ|锁
yǐwéi|以为
shīhuǒ|失火
shāo|烧
sǐ|死
dānwèi|单位
tōu|偷
tīngshuō|听说
zhòngyào|重要
xiǎotōu|小偷
gùrán|固然
fángfàn|防范
huǒzāi|火灾
shānghài|伤害
tōuqiè|偷窃
dǐngduō|顶多
búguò|不过
zhàoxiàngjī|照相机
huò|或
xiànjīn|现金
yídàn|一旦
kěnéng|可能
shènzhì|甚至
cáichǎn|财产
sǔnshī|损失
yuǎnyuǎn|远远
chāoguò|超过
yíbèizi|一辈子
pèng|碰
zhǔyào|主要
zhuóxiǎng|着想
lǐngdǎo|领导
huìbào|汇报